Estação de origem,Estação de Destino,contagem_viagens,contagem_acumulada,rank,freq_acumulada
Brasil 21,Brasil 21,1296,1296,1,2.797867058137778
ICC Sul,Centro Olímpico,640,1936,2,4.179529802897174
Instituto de Artes,Centro Olímpico,623,2559,3,5.524492130998899
Centro Olímpico,ICC Sul,587,3146,4,6.791735929707908
Deck Sul,Deck Sul,475,3621,5,7.817188748084022
Centro Olímpico,Instituto de Artes,458,4079,6,8.805941149802464
Ministério da Saude,Rodoviária 2,387,4466,7,9.641415340774163
EQN 408/409,Instituto de Artes,378,4844,8,10.45745989939768
Instituto de Artes,EQN 408/409,369,5213,9,11.25407482567302
CLN 406,Instituto de Artes,320,5533,10,11.94490619805272
EQN 410/411,EQN 410/411,320,5853,11,12.635737570432418
Instituto de Artes,CLN 406,277,6130,12,13.233738477148593
Instituto de Artes,EQN 410/411,276,6406,13,13.829580535826084
EQN 410/411,Instituto de Artes,275,6681,14,14.423263746464887
Rodoviária 2,Ministério da Saude,270,6951,15,15.006152716910256
CLN 406,EQN 408/409,269,7220,16,15.58688283931694
EQN 408/409,CLN 406,266,7486,17,16.161136417607562
CLN 406,EQN 410/411,264,7750,18,16.731072299820816
EQN 410/411,CLN 406,264,8014,19,17.301008182034067
Rodoviária,Ministério da Saude,236,8250,20,17.810496319164095
Ministério da Cultura,Rodoviária 2,232,8482,21,18.311349064139375
EQN 408/409,EQN 410/411,232,8714,22,18.812201809114658
Ministério da Defesa,Rodoviária,230,8944,23,19.308736858012566
EQN 408/409,EQN 408/409,228,9172,24,19.800954210833098
EQN 410/411,EQN 408/409,227,9399,25,20.291012715614947
EQS 204/205,EQS 204/205,219,9618,26,20.763800436087305
Rodoviária,Ministério dos Transportes,215,9833,27,21.227952764404915
Ministério dos Transportes,Rodoviária,215,10048,28,21.692105092722525
Deck Sul Kids,Deck Sul Kids,202,10250,29,22.12819239653721
Ministério do Planejamento,Rodoviária,198,10448,30,22.555644308197145
CLN 406,ICC Sul,194,10642,31,22.97446082770234
Centro Olímpico,Centro Olímpico,192,10834,32,23.388959651130158
Ministério da Saude,Rodoviária,187,11021,33,23.792664234364544
Instituto de Artes,PAT,187,11208,34,24.19636881759893
Rodoviária 3,Ministério da Saude,185,11393,35,24.59575570475594
Ministério da Cultura,Rodoviária,183,11576,36,24.99082489583558
STF,Rodoviária 2,180,11756,37,25.37941754279916
CLN 406,PAT,177,11933,38,25.761533645646683
Rodoviária,Ministério do Planejamento,175,12108,39,26.13933205241683
PAT,CLN 406,172,12280,40,26.510653915070918
PAT,Instituto de Artes,172,12452,41,26.881975777725003
PAT,ICC Sul,170,12622,42,27.24897994430172
ICC Sul,ICC Sul,169,12791,43,27.613825262839747
Torre de TV,Torre de TV,169,12960,44,27.97867058137778
Instituto de Artes,Instituto de Artes,163,13123,45,28.330562811683684
EQN 408/409,PAT,161,13284,46,28.67813734591222
Rodoviária,Ministério da Cultura,160,13444,47,29.023553032102072
Centro de Convenções,Rodoviária 3,158,13602,48,29.364651022214545
W2/EQN305/306,Instituto de Artes,154,13756,49,29.697113620172278
Praça Buriti,Rodoviária 3,154,13910,50,30.029576218130003
SRTVS,Brasil 21,151,14061,51,30.355562271971674
CLN 406,CLN 406,150,14211,52,30.67938947777466
Rodoviária 2,Ministério da Cultura,148,14359,53,30.99889898750027
CLN 204,CLN 204,147,14506,54,31.316249649187196
CLN 406,Centro Olímpico,146,14652,55,31.63144146283543
Instituto de Artes,ICC Sul,144,14796,56,31.942315580406294
Rodoviária,Ministério da Defesa,144,14940,57,32.253189697977156
Catedral Metropolitana,Rodoviária 2,144,15084,58,32.564063815548025
ICC Sul,PAT,142,15226,59,32.870620237041514
Rodoviária 2,STF,141,15367,60,33.17501781049632
Catedral Metropolitana,Catedral Metropolitana,140,15507,61,33.47725653591244
CLN 403,CLN 406,138,15645,62,33.77517756525118
CLN 406,CLN 403,138,15783,63,34.07309859458993
102 Sul,Shopping Mall,134,15917,64,34.36238423177392
CNMP - Conselho Nacional do Ministério Público,Rodoviária 2,134,16051,65,34.651669868957924
SRTVS,Galeria,133,16184,66,34.938796658103236
Memorial JK,Rodoviária 3,133,16317,67,35.22592344724855
Centro Olímpico,Biblioteca Central,129,16446,68,35.504414844239115
TSE,Rodoviária 2,128,16574,69,35.78074739319099
Memorial JK,Memorial JK,125,16699,70,36.050603398026816
Rodoviária 3,Ministério da Cultura,123,16822,71,36.31614170678526
EQN 104/105,EQN 104/105,123,16945,72,36.581680015543704
W2/EQN305/306,SQN 205,123,17068,73,36.84721832430215
Brasil 21,SRTVS,121,17189,74,37.10843893698323
PAT,EQN 408/409,121,17310,75,37.3696595496643
Instituto de Artes,Biblioteca Central,121,17431,76,37.63088016234537
EQN 410/411,PAT,120,17551,77,37.88994192698776
SQS 305,SQS 305,119,17670,78,38.14684484359146
Setor Hoteleiro Norte,Rodoviária 3,118,17788,79,38.40158891215648
PAT,Centro Olímpico,118,17906,80,38.65633298072149
CLN 403,CLN 403,116,18022,81,38.906759353209125
Brasil 21,Rodoviária 3,115,18137,82,39.15502687765808
ICC Sul,CLN 406,114,18251,83,39.401135554068354
Rodoviária 2,Ministério dos Transportes,114,18365,84,39.64724423047862
Shopping Pátio Brasil,Rodoviária 3,110,18475,85,39.884717514734135
SQN 205,Instituto de Artes,110,18585,86,40.12219079898966
EQN 408/409,ICC Sul,109,18694,87,40.35750523520649
Rodoviária 3,Ministério do Planejamento,109,18803,88,40.59281967142333
SQN 205,ICC Sul,108,18911,89,40.82597525960148
STF,Rodoviária,108,19019,90,41.05913084777962
Brasília Shopping,Rodoviária 3,106,19125,91,41.2879687398804
Centro Olímpico,PAT,105,19230,92,41.514647783942486
ICC Sul,EQN 408/409,104,19334,93,41.73916797996589
Rodoviária 2,Ministério do Planejamento,104,19438,94,41.9636881759893
Catedral Metropolitana,STF,103,19541,95,42.186049523974006
ICC Sul,Instituto de Artes,102,19643,96,42.40625202392004
INMETRO,EQN 104/105,101,19744,97,42.624295675827376
EQS 202 / 203,EQS 202 / 203,101,19845,98,42.84233932773472
Centro de Convenções,Centro de Convenções,100,19945,99,43.05822413160338
EQN 408/409,Centro Olímpico,100,20045,100,43.274108935472036
Shopping Pátio Brasil,Galeria,98,20143,101,43.48567604326332
PAT,PAT,98,20241,102,43.6972431510546
Torre de TV,Brasil 21,98,20339,103,43.90881025884588
Rodoviária 2,Ministério da Defesa,97,20436,104,44.118218518598475
Shopping Mall,102 Sul,97,20533,105,44.32762677835107
SQN 205,SQN 205,97,20630,106,44.53703503810367
102 Sul,102 Sul,96,20726,107,44.74428444981758
INMETRO,INMETRO,96,20822,108,44.95153386153149
Ministério da Cultura,Ministério da Cultura,94,20916,109,45.154465577168025
Rodoviária,Rodoviária,93,21009,110,45.355238444765874
ICC Sul,Biblioteca Central,93,21102,111,45.55601131236372
Centro Olímpico,CLN 406,93,21195,112,45.75678417996157
CLN 204,SQN 205,92,21287,113,45.95539819952074
Catedral Metropolitana,Rodoviária,91,21378,114,46.15185337104121
Rodoviária,STF,91,21469,115,46.34830854256169
Rodoviária,Instituto de Artes,91,21560,116,46.544763714082166
Instituto de Artes,Rodoviária,90,21650,117,46.73906003756396
W2/EQN305/306,W2/EQN305/306,90,21740,118,46.933356361045746
Torre de TV,Rodoviária 3,89,21829,119,47.12549383648885
CLN 403,Instituto de Artes,89,21918,120,47.317631311931954
Rodoviária,CLN 403,88,22006,121,47.50760993933637
PAT,EQN 410/411,87,22093,122,47.6954297187021
CLN 204,CLN 406,86,22179,123,47.881090650029144
SRTVS,SRTVS,86,22265,124,48.066751581356186
EQN 410/411,ICC Sul,85,22350,125,48.250253664644546
Shopping Pátio Brasil,Shopping Pátio Brasil,83,22433,126,48.42943805185553
CLN 406,Biblioteca Central,83,22516,127,48.608622439066515
Rodoviária,Catedral Metropolitana,82,22598,128,48.78564797823881
Instituto de Artes,SQN 205,82,22680,129,48.96267351741111
Ministério da Saude,Rodoviária 3,82,22762,130,49.13969905658341
W2/EQN305/306,CLN 406,82,22844,131,49.31672459575571
Rodoviária,ICC Sul,82,22926,132,49.49375013492801
Rodoviária 2,Catedral Metropolitana,81,23007,133,49.668616826061616
Biblioteca Central,Centro Olímpico,80,23087,134,49.84132466915654
Praça Buriti,Rodoviária 2,80,23167,135,50.01403251225146
Rodoviária 2,TSE,79,23246,136,50.184581507307705
Rodoviária 3,Shopping Pátio Brasil,79,23325,137,50.35513050236394
Catedral Metropolitana,Ministério da Saude,78,23403,138,50.523520649381496
Setor Hoteleiro Norte,Setor Hoteleiro Norte,77,23480,139,50.68975194836035
STF,Catedral Metropolitana,77,23557,140,50.85598324733922
Galeria,Galeria,76,23633,141,51.0200556982794
Rodoviária 2,Instituto de Artes,75,23708,142,51.181969301180885
Ministério dos Transportes,Ministério dos Transportes,75,23783,143,51.343882904082385
Setor Hoteleiro Norte,Rodoviária 2,73,23856,144,51.5014788109065
EQS 104/304,EQS 104/304,73,23929,145,51.659074717730626
Rodoviária 3,Ministério da Defesa,73,24002,146,51.81667062455474
CNMP - Conselho Nacional do Ministério Público,Rodoviária,72,24074,147,51.97210768334018
Biblioteca Central,Biblioteca Central,72,24146,148,52.1275447421256
Rodoviária 3,Rodoviária 3,71,24217,149,52.280822952872356
EQN 104/105,INMETRO,71,24288,150,52.4341011636191
SQN 205,PAT,71,24359,151,52.58737937436584
CLN 403,ICC Sul,71,24430,152,52.74065758511258
EQS 202 / 203,EQS 204/205,70,24500,153,52.891776947820645
Rodoviária 2,CNMP - Conselho Nacional do Ministério Público,70,24570,154,53.0428963105287
Galeria,SRTVS,70,24640,155,53.19401567323676
Biblioteca Central,Instituto de Artes,69,24709,156,53.34297618790613
CLN 403,EQN 408/409,69,24778,157,53.4919367025755
Biblioteca Central,ICC Sul,69,24847,158,53.64089721724488
ICC Sul,EQN 410/411,68,24915,159,53.78769888387557
Rodoviária 3,Centro de Convenções,68,24983,160,53.93450055050625
PAT,Biblioteca Central,68,25051,161,54.08130221713694
Galeria,Brasil 21,68,25119,162,54.228103883767616
Shopping Pátio Brasil,Brasil 21,67,25186,163,54.37274670235962
SAS,Rodoviária 2,67,25253,164,54.51738952095162
Centro de Convenções,Brasil 21,67,25320,165,54.66203233954362
EQN 104/105,Instituto de Artes,67,25387,166,54.80667515813562
Rodoviária 2,ICC Sul,66,25453,167,54.949159128688926
CLN 204,CLN 403,66,25519,168,55.09164309924225
Ministério da Saude,Ministério da Saude,65,25584,169,55.231968221756865
EQS 204/205,EQS 202 / 203,65,25649,170,55.3722933442715
Shopping Pátio Brasil,Rodoviária 2,65,25714,171,55.51261846678612
Ministério da Cultura,Rodoviária 3,65,25779,172,55.652943589300754
Rodoviária 3,STF,64,25843,173,55.79110986377669
SQN 205,CLN 204,64,25907,174,55.929276138252625
Brasília Shopping,Brasília Shopping,64,25971,175,56.06744241272856
Torre de TV,Rodoviária 2,62,26033,176,56.20129099112714
Brasília Shopping,Rodoviária,62,26095,177,56.33513956952571
Centro Olímpico,EQN 408/409,62,26157,178,56.46898814792427
EQN 104/105,CLN 406,62,26219,179,56.602836726322835
SRTVS,Rodoviária 3,62,26281,180,56.736685304721405
ICC Sul,Rodoviária,62,26343,181,56.87053388311997
CLN 403,EQN 410/411,61,26404,182,57.00222361347985
Brasil 21,Torre de TV,60,26464,183,57.13175449580105
Rodoviária 2,Rodoviária 2,60,26524,184,57.26128537812223
Shopping Pátio Brasil,Rodoviária,59,26583,185,57.38865741240474
EQN 408/409,Biblioteca Central,59,26642,186,57.51602944668724
SQN 205,EQN 410/411,59,26701,187,57.64340148096976
Rodoviária 2,CLN 406,59,26760,188,57.77077351525226
Ministério do Planejamento,Rodoviária 2,58,26818,189,57.895986701496085
Rodoviária 3,Catedral Metropolitana,58,26876,190,58.021199887739904
Rodoviária 3,Ministério dos Transportes,58,26934,191,58.14641307398373
Rodoviária 2,Rodoviária,57,26991,192,58.26946741218886
CLN 403,Rodoviária,57,27048,193,58.39252175039399
CLN 204,EQN 410/411,56,27104,194,58.513417240560436
EQN 410/411,Biblioteca Central,56,27160,195,58.63431273072689
Liberty Mall,W2/EQN305/306,56,27216,196,58.75520822089333
SQN 205,CLN 406,56,27272,197,58.87610371105978
Setor Hoteleiro Norte,Rodoviária,55,27327,198,58.99484035318754
Banco Central,EQS 204/205,55,27382,199,59.1135769953153
SQS 305,102 Sul,55,27437,200,59.232313637443056
EQS 104/304,102 Sul,55,27492,201,59.35105027957081
Brasil 21,Shopping Pátio Brasil,55,27547,202,59.469786921698585
Brasília Shopping,W2/EQN305/306,55,27602,203,59.58852356382634
Ministério da Saude,Catedral Metropolitana,54,27656,204,59.70510135791541
CLN 204,ICC Sul,54,27710,205,59.82167915200449
102 Sul,SQS 305,54,27764,206,59.93825694609356
Memorial JK,Rodoviária 2,54,27818,207,60.05483474018264
CLN 204,Instituto de Artes,54,27872,208,60.17141253427172
SAS,Rodoviária,53,27925,209,60.2858314803221
102 Sul,EQS 204/205,53,27978,210,60.400250426372494
EQS 204/205,Banco Central,53,28031,211,60.51466937242288
STF,STF,53,28084,212,60.629088318473265
Ministério do Planejamento,Ministério do Planejamento,53,28137,213,60.74350726452366
CLN 204,Rodoviária,52,28189,214,60.85576736253535
W2/EQN305/306,CLN 204,52,28241,215,60.96802746054705
ICC Sul,CLN 204,52,28293,216,61.08028755855875
Instituto de Artes,CLN 403,51,28344,217,61.19038880853177
W2/EQN305/306,ICC Sul,51,28395,218,61.300490058504785
Rodoviária 3,Brasil 21,50,28445,219,61.40843246043911
Shopping Mall,Shopping Mall,50,28495,220,61.51637486237343
EQN 410/411,SQN 205,49,28544,221,61.62215841626908
Ministério do Planejamento,Ministério dos Transportes,49,28593,222,61.72794197016472
Brasil 21,Rodoviária,49,28642,223,61.833725524060355
Brasil 21,Galeria,49,28691,224,61.939509077956004
Biblioteca Central,CLN 406,49,28740,225,62.045292631851645
CLN 406,SQN 205,49,28789,226,62.151076185747286
Rodoviária 2,EQN 408/409,49,28838,227,62.25685973964292
ICC Sul,CLN 403,49,28887,228,62.36264329353857
W2/EQN305/306,Liberty Mall,49,28936,229,62.46842684743421
Rodoviária 2,CLN 403,49,28985,230,62.57421040132986
Instituto de Artes,CLN 204,48,29033,231,62.67783510718681
Galeria,EQS 104/304,48,29081,232,62.78145981304376
Rodoviária,EQN 408/409,48,29129,233,62.88508451890071
EQN 410/411,Centro Olímpico,48,29177,234,62.98870922475766
EQN 408/409,Rodoviária,48,29225,235,63.09233393061462
CLN 406,CLN 204,47,29272,236,63.19379978843289
EQN 104/105,CLN 204,47,29319,237,63.29526564625117
SRTVS,Banco Central,46,29365,238,63.394572656030746
Brasil 21,Rodoviária 2,46,29411,239,63.493879665810326
Brasil 21,Memorial JK,46,29457,240,63.593186675589905
Rodoviária,CLN 406,46,29503,241,63.69249368536949
W2/EQN305/306,PAT,46,29549,242,63.79180069514907
STF,TSE,45,29594,243,63.88894885688996
Rodoviária,TSE,45,29639,244,63.98609701863086
PAT,Rodoviária,45,29684,245,64.08324518037175
Centro Olímpico,EQN 410/411,45,29729,246,64.18039334211265
EQN 408/409,CLN 403,45,29774,247,64.27754150385354
Banco Central,TSE,44,29818,248,64.37253081755576
Shopping Mall,EQS 204/205,44,29862,249,64.46752013125796
Biblioteca Central,EQN 408/409,44,29906,250,64.56250944496017
EQS 204/205,102 Sul,44,29950,251,64.65749875866238
SRTVS,Rodoviária 2,44,29994,252,64.75248807236459
EQS 204/205,SAS,44,30038,253,64.8474773860668
Biblioteca Central,PAT,43,30081,254,64.94030785173031
Instituto de Artes,W2/EQN305/306,43,30124,255,65.03313831739383
Centro Olímpico,Rodoviária,43,30167,256,65.12596878305736
Rodoviária 3,Setor Hoteleiro Norte,43,30210,257,65.21879924872088
EQN 410/411,CLN 403,43,30253,258,65.3116297143844
INMETRO,CLN 204,43,30296,259,65.40446018004793
Praça Buriti,Praça Buriti,43,30339,260,65.49729064571144
Galeria,Shopping Pátio Brasil,43,30382,261,65.59012111137497
Centro de Convenções,Rodoviária 2,42,30424,262,65.6807927289998
Ministério do Planejamento,Rodoviária 3,41,30465,263,65.76930549858595
Ministério da Defesa,Ministério da Defesa,41,30506,264,65.85781826817211
Ministério da Defesa,Rodoviária 2,41,30547,265,65.94633103775826
CNMP - Conselho Nacional do Ministério Público,Catedral Metropolitana,41,30588,266,66.0348438073444
Rodoviária,CNMP - Conselho Nacional do Ministério Público,41,30629,267,66.12335657693055
Rodoviária 3,Rodoviária,41,30670,268,66.21186934651669
CLN 403,CLN 204,41,30711,269,66.30038211610285
Rodoviária,Rodoviária 2,41,30752,270,66.388894885689
EQS 104/304,SQS 305,41,30793,271,66.47740765527514
SQS 305,Galeria,41,30834,272,66.56592042486129
EQN 410/411,CLN 204,41,30875,273,66.65443319444744
102 Sul,Brasil 21,40,30915,274,66.7407871159949
Brasil 21,SQS 305,40,30955,275,66.82714103754238
Ministério da Cultura,STF,40,30995,276,66.91349495908983
EQS 202 / 203,TSE,40,31035,277,66.99984888063729
CLN 204,EQN 408/409,40,31075,278,67.08620280218476
EQN 410/411,Rodoviária,39,31114,279,67.17039787569354
EQN 104/105,PAT,39,31153,280,67.2545929492023
Centro de Convenções,Torre de TV,39,31192,281,67.33878802271109
SQS 305,EQS 204/205,39,31231,282,67.42298309621985
Banco Central,CNMP - Conselho Nacional do Ministério Público,39,31270,283,67.50717816972863
Rodoviária 3,W2/EQN305/306,39,31309,284,67.59137324323741
Shopping Mall,EQS 202 / 203,39,31348,285,67.67556831674618
Catedral Metropolitana,Rodoviária 3,38,31386,286,67.75760454221627
Rodoviária,PAT,38,31424,287,67.83964076768636
CLN 406,W2/EQN305/306,38,31462,288,67.92167699315645
Biblioteca Central,EQN 410/411,38,31500,289,68.00371321862654
102 Sul,Galeria,38,31538,290,68.08574944409663
Rodoviária 3,Torre de TV,38,31576,291,68.16778566956671
Galeria,EQS 204/205,38,31614,292,68.24982189503682
INMETRO,Instituto de Artes,38,31652,293,68.3318581205069
EQN 104/105,EQN 408/409,37,31689,294,68.4117354979383
Praça do Povo,Galeria,37,31726,295,68.4916128753697
Setor Hoteleiro Norte,Centro de Convenções,37,31763,296,68.5714902528011
Praça do Povo,Brasil 21,37,31800,297,68.65136763023251
Liberty Mall,EQN 104/105,37,31837,298,68.73124500766392
EQN 104/105,ICC Sul,37,31874,299,68.81112238509532
INMETRO,Liberty Mall,37,31911,300,68.89099976252672
CLN 406,Rodoviária,37,31948,301,68.97087713995812
SQN 205,EQN 408/409,37,31985,302,69.05075451738952
Rodoviária 3,Praça Buriti,37,32022,303,69.13063189482092
EQS 104/304,EQS 202 / 203,37,32059,304,69.21050927225232
TSE,Rodoviária,37,32096,305,69.29038664968374
Rodoviária 3,Rodoviária 2,36,32132,306,69.36810517907645
Ministério do Planejamento,Ministério da Cultura,36,32168,307,69.44582370846916
Rodoviária 3,EQN 104/105,36,32204,308,69.52354223786188
Torre de TV,Setor Hoteleiro Norte,36,32240,309,69.60126076725459
102 Sul,EQS 104/304,36,32276,310,69.67897929664731
ICC Sul,SQN 205,36,32312,311,69.75669782604002
Shopping Pátio Brasil,Brasília Shopping,36,32348,312,69.83441635543274
Brasília Shopping,Rodoviária 2,36,32384,313,69.91213488482546
SQN 205,EQN 104/105,36,32420,314,69.98985341421817
Praça Buriti,Shopping Pátio Brasil,36,32456,315,70.06757194361089
Rodoviária 3,CNMP - Conselho Nacional do Ministério Público,36,32492,316,70.14529047300361
Memorial JK,Rodoviária,35,32527,317,70.22085015435763
W2/EQN305/306,INMETRO,35,32562,318,70.29640983571166
Galeria,102 Sul,35,32597,319,70.3719695170657
Banco Central,Banco Central,35,32632,320,70.44752919841972
EQN 104/105,Rodoviária 2,35,32667,321,70.52308887977375
Rodoviária,CLN 204,35,32702,322,70.59864856112779
EQN 408/409,SQN 205,35,32737,323,70.67420824248181
Brasília Shopping,Liberty Mall,35,32772,324,70.74976792383583
TSE,EQS 202 / 203,35,32807,325,70.82532760518987
Banco Central,EQS 202 / 203,35,32842,326,70.9008872865439
CLN 403,Ministério da Saude,35,32877,327,70.97644696789793
EQS 202 / 203,Rodoviária 2,35,32912,328,71.05200664925196
EQN 104/105,Liberty Mall,35,32947,329,71.12756633060599
EQN 104/105,EQN 410/411,34,32981,330,71.20096716392133
Rodoviária 2,CLN 204,34,33015,331,71.27436799723668
Rodoviária 3,Brasília Shopping,34,33049,332,71.34776883055201
CLN 403,Rodoviária 2,34,33083,333,71.42116966386736
CLN 204,Rodoviária 2,34,33117,334,71.4945704971827
ICC Sul,Catedral Metropolitana,34,33151,335,71.56797133049805
Rodoviária 2,EQS 202 / 203,34,33185,336,71.64137216381339
Centro de Convenções,Setor Hoteleiro Norte,34,33219,337,71.71477299712873
Memorial JK,Brasil 21,34,33253,338,71.78817383044408
Ministério da Saude,TSE,33,33286,339,71.85941581572072
Rodoviária 3,Memorial JK,33,33319,340,71.9306578009974
Ministério dos Transportes,Rodoviária 2,33,33352,341,72.00189978627405
Memorial JK,Torre de TV,33,33385,342,72.0731417715507
Centro de Convenções,Rodoviária,33,33418,343,72.14438375682735
W2/EQN305/306,Brasília Shopping,33,33451,344,72.21562574210402
Torre de TV,Memorial JK,33,33484,345,72.28686772738067
Brasil 21,Centro de Convenções,33,33517,346,72.35810971265732
Rodoviária 2,W2/EQN305/306,32,33549,347,72.42719284989529
Galeria,Shopping Mall,32,33581,348,72.49627598713326
SQN 205,Centro Olímpico,32,33613,349,72.56535912437123
EQN 104/105,SQN 205,32,33645,350,72.6344422616092
W2/EQN305/306,Rodoviária,32,33677,351,72.70352539884718
Ministério da Cultura,Catedral Metropolitana,32,33709,352,72.77260853608514
EQN 104/105,CLN 403,32,33741,353,72.84169167332311
EQS 204/205,Shopping Mall,32,33773,354,72.91077481056108
EQN 104/105,W2/EQN305/306,32,33805,355,72.97985794779905
Rodoviária,EQN 104/105,32,33837,356,73.04894108503703
Rodoviária,EQN 410/411,32,33869,357,73.118024222275
Rodoviária,SAS,32,33901,358,73.18710735951296
Liberty Mall,Brasília Shopping,32,33933,359,73.25619049675095
SQS 305,EQS 104/304,31,33964,360,73.32311478595021
102 Sul,SRTVS,31,33995,361,73.3900390751495
Memorial JK,Setor Hoteleiro Norte,31,34026,362,73.45696336434878
Ministério dos Transportes,Catedral Metropolitana,31,34057,363,73.52388765354807
Memorial JK,Brasília Shopping,31,34088,364,73.59081194274735
W2/EQN305/306,Rodoviária 2,31,34119,365,73.65773623194663
Galeria,Rodoviária,31,34150,366,73.7246605211459
INMETRO,W2/EQN305/306,31,34181,367,73.7915848103452
EQS 202 / 203,Banco Central,31,34212,368,73.85850909954448
Rodoviária 2,PAT,31,34243,369,73.92543338874377
PAT,SQN 205,30,34273,370,73.99019882990436
Brasília Shopping,Shopping Pátio Brasil,30,34303,371,74.05496427106496
Shopping Mall,Galeria,30,34333,372,74.11972971222556
Shopping Pátio Brasil,STF,30,34363,373,74.18449515338615
EQN 408/409,CLN 204,30,34393,374,74.24926059454675
Rodoviária 3,TSE,30,34423,375,74.31402603570734
Setor Hoteleiro Norte,Shopping Pátio Brasil,29,34452,376,74.37663262882926
Brasília Shopping,EQN 104/105,29,34481,377,74.43923922195117
Memorial JK,Shopping Pátio Brasil,29,34510,378,74.50184581507308
Ministério dos Transportes,Ministério do Planejamento,29,34539,379,74.564452408195
Praça Buriti,Brasil 21,29,34568,380,74.6270590013169
Praça do Povo,Praça do Povo,28,34596,381,74.68750674640012
Praça do Povo,SRTVS,28,34624,382,74.74795449148334
Praça Buriti,Banco Central,28,34652,383,74.80840223656658
Galeria,Ministério da Defesa,28,34680,384,74.86884998164979
Rodoviária,Biblioteca Central,28,34708,385,74.92929772673301
Shopping Mall,Brasil 21,28,34736,386,74.98974547181624
Memorial JK,Praça Buriti,28,34764,387,75.05019321689946
SRTVS,102 Sul,28,34792,388,75.11064096198268
SRTVS,Rodoviária,28,34820,389,75.17108870706592
SQN 205,W2/EQN305/306,28,34848,390,75.23153645214913
CNMP - Conselho Nacional do Ministério Público,EQS 202 / 203,28,34876,391,75.29198419723235
EQS 204/205,SQS 305,27,34903,392,75.3502730942769
Ministério da Saude,CNMP - Conselho Nacional do Ministério Público,27,34930,393,75.40856199132143
Ministério da Cultura,Ministério do Planejamento,27,34957,394,75.46685088836597
W2/EQN305/306,EQN 410/411,27,34984,395,75.5251397854105
INMETRO,Rodoviária,27,35011,396,75.58342868245505
Centro de Convenções,Memorial JK,27,35038,397,75.64171757949958
Galeria,Liberty Mall,27,35065,398,75.70000647654412
SQN 205,Biblioteca Central,27,35092,399,75.75829537358865
Catedral Metropolitana,CLN 403,27,35119,400,75.81658427063319
SAS,EQS 202 / 203,27,35146,401,75.87487316767772
Shopping Mall,Rodoviária 3,26,35172,402,75.93100321668358
SRTVS,Praça do Povo,26,35198,403,75.98713326568944
SAS,EQS 204/205,26,35224,404,76.04326331469528
Liberty Mall,Liberty Mall,26,35250,405,76.09939336370113
Galeria,CLN 403,26,35276,406,76.15552341270698
Rodoviária,EQS 202 / 203,26,35302,407,76.21165346171283
INMETRO,CLN 406,26,35328,408,76.26778351071867
Ministério do Planejamento,CLN 403,26,35354,409,76.32391355972453
STF,Rodoviária 3,26,35380,410,76.38004360873039
ICC Sul,W2/EQN305/306,26,35406,411,76.43617365773623
CLN 204,INMETRO,25,35431,412,76.49014485870339
Rodoviária,Banco Central,25,35456,413,76.54411605967056
CLN 204,PAT,25,35481,414,76.59808726063773
Praça do Povo,Setor Hoteleiro Norte,25,35506,415,76.6520584616049
Rodoviária 2,Centro de Convenções,25,35531,416,76.70602966257205
Rodoviária 2,Shopping Pátio Brasil,25,35556,417,76.76000086353922
Instituto de Artes,EQN 104/105,25,35581,418,76.81397206450637
SQS 305,Brasil 21,25,35606,419,76.86794326547354
Galeria,CNMP - Conselho Nacional do Ministério Público,25,35631,420,76.92191446644071
Ministério do Planejamento,Banco Central,25,35656,421,76.97588566740788
Ministério dos Transportes,CLN 403,25,35681,422,77.02985686837503
Ministério da Saude,Ministério da Cultura,25,35706,423,77.0838280693422
CLN 403,SQN 205,24,35730,424,77.13564042227068
Memorial JK,Centro de Convenções,24,35754,425,77.18745277519915
Rodoviária,Brasil 21,24,35778,426,77.23926512812763
Liberty Mall,INMETRO,24,35802,427,77.2910774810561
Shopping Pátio Brasil,Catedral Metropolitana,24,35826,428,77.34288983398459
102 Sul,Rodoviária,24,35850,429,77.39470218691307
EQS 202 / 203,EQS 104/304,24,35874,430,77.44651453984154
Ministério do Planejamento,Ministério da Saude,24,35898,431,77.49832689277002
SRTVS,Shopping Pátio Brasil,24,35922,432,77.55013924569849
SQN 205,CLN 403,24,35946,433,77.60195159862697
Praça do Povo,SQS 305,24,35970,434,77.65376395155545
Rodoviária 3,SAS,24,35994,435,77.70557630448393
SAS,Catedral Metropolitana,24,36018,436,77.7573886574124
Brasil 21,Setor Hoteleiro Norte,24,36042,437,77.80920101034087
Shopping Pátio Brasil,Praça do Povo,24,36066,438,77.86101336326936
Memorial JK,SQN 205,24,36090,439,77.91282571619784
CLN 403,PAT,24,36114,440,77.96463806912631
Banco Central,Shopping Pátio Brasil,24,36138,441,78.01645042205479
Rodoviária 2,Brasília Shopping,23,36161,442,78.06610392694459
SAS,Ministério do Planejamento,23,36184,443,78.11575743183438
Liberty Mall,Instituto de Artes,23,36207,444,78.16541093672417
Praça Buriti,Rodoviária,23,36230,445,78.21506444161396
Memorial JK,W2/EQN305/306,23,36253,446,78.26471794650375
Galeria,Banco Central,23,36276,447,78.31437145139354
Galeria,Brasília Shopping,23,36299,448,78.36402495628333
Banco Central,EQN 410/411,23,36322,449,78.41367846117312
Liberty Mall,Galeria,23,36345,450,78.46333196606291
EQS 204/205,Rodoviária 2,23,36368,451,78.5129854709527
CLN 204,W2/EQN305/306,23,36391,452,78.56263897584249
Torre de TV,Centro de Convenções,23,36414,453,78.61229248073228
Rodoviária 3,SRTVS,22,36436,454,78.65978713758338
STF,Ministério da Saude,22,36458,455,78.7072817944345
CLN 403,Centro Olímpico,22,36480,456,78.7547764512856
Setor Hoteleiro Norte,W2/EQN305/306,22,36502,457,78.80227110813671
Rodoviária,Centro Olímpico,22,36524,458,78.8497657649878
Brasília Shopping,CLN 403,22,36546,459,78.89726042183891
INMETRO,ICC Sul,22,36568,460,78.94475507869001
Praça Buriti,Centro de Convenções,22,36590,461,78.99224973554112
Ministério do Planejamento,SAS,22,36612,462,79.03974439239222
EQN 104/105,Rodoviária 3,22,36634,463,79.08723904924332
Shopping Pátio Brasil,Setor Hoteleiro Norte,22,36656,464,79.13473370609442
Rodoviária,Shopping Pátio Brasil,22,36678,465,79.18222836294552
Shopping Pátio Brasil,W2/EQN305/306,22,36700,466,79.22972301979664
Setor Hoteleiro Norte,Torre de TV,22,36722,467,79.27721767664774
Rodoviária 3,CLN 403,22,36744,468,79.32471233349885
TSE,Banco Central,22,36766,469,79.37220699034995
Torre de TV,SRTVS,22,36788,470,79.41970164720105
Rodoviária 3,102 Sul,22,36810,471,79.46719630405215
Ministério dos Transportes,CLN 406,22,36832,472,79.51469096090327
Rodoviária 3,Galeria,22,36854,473,79.56218561775437
Setor Hoteleiro Norte,Galeria,21,36875,474,79.60752142656679
Rodoviária 3,Liberty Mall,21,36896,475,79.6528572353792
Galeria,SQS 305,21,36917,476,79.69819304419163
Banco Central,Ministério da Saude,21,36938,477,79.74352885300404
SQS 305,EQS 202 / 203,21,36959,478,79.78886466181645
Liberty Mall,CLN 204,21,36980,479,79.83420047062887
INMETRO,PAT,21,37001,480,79.87953627944128
Liberty Mall,Praça Buriti,21,37022,481,79.92487208825371
Ministério da Cultura,Ministério dos Transportes,21,37043,482,79.97020789706613
